0000000000000000
0000000000000000
0000000000000000
0000000000000000
0000001111000000
0000000000000000
0000000000000000
0111000000001110
0000000000000000
0000011111100000
0000000000000000
4006000000070005
1111111111111111
