0000000000000000
0000000000000000
0000000000000000
0000000000000000
0000000000000000
0000000000000000
0000000000000000
1110000000000111
0000000000000000
0000011221100000
0000000000000000
4060000000007005
1111111111111111
