0000000000000000
0000000000000000
0000000000000000
0000000000000000
0000000000000000
0000000000000000
0000000000000000
0003300000033000
0001100330011000
0000200110020000
0000000000000000
4600000000000705
1111111111111111
