0000000000000000
0000000000000000
0000000000000000
0000000000000000
0000000000000000
0000000000000007
0000000000000011
0000000000000000
0000000330000100
0000121111210000
0000000000000000
4060003333000005
1111111111111111
