0000000000000000
4000700000070005
1111110000111111
0000000000000000
0000333333330000
3300111111110033
1100000000000011
0000000000000000
3333300000033333
1111100220011111
0000000000000000
4060000000000005
1111111111111111
